####.########.###
####.#####......#
#......###......#
#......###......#
#...............#
.......###.......
#......###......#
##.#######......#
##.#########.####
##.#########.####
##.......##....##
.........##......
##.............##
##.......##....##
##.......####.###
####.########.###